################################################
#                     *                      E #
#  ####      ####                               #
#  #  #      #  #          *                    #
#  ####      ####                               #
#                                              ##
#      *                                        #
#                     #######                   #
#   @                 #     #                   #
#                     #######                   #
#                                               
#                *                              
#                                               
#                                               
#                                               
################################################
